70 FRucm-JFJCArgosw

 

Tres in fingulo filamentoe Pomaria:
Quinque in tribus filamentis: Bryonia.
in fingulo filamento ε Τήεοὺνοηιαρ
Loculo unico: flffcrcurialis. 2
gemino: HelleboruS.
trino: Orclzis.
quaterno ; Fritillaria. ,
Defec‘ffi unius: Chelone , ‚M'artynim
Duorum : Pinguicula, V erbena. -
Trium ε Gratiola , Bz'gnoniae, Gerania.
Quatuor: Curcuma. ε·
Quinque: Pentapetes, Gerania.
FiguraOblongazLilium. ·
Globosa : Mercurialis.
sagittata: Crocus.
Angulata : Tulz'pa, ἢ
Cornuta: Hamamelis ‚ Erica, V acciniafflyrola.
Dehg'scentia Latere3 Plerique, Leucojum.
Apice: Calantlzue , Kiggelaria.
aBafi ad Apicem discedens: Epimeae
dium, Leontice. ³ ‘
connexione Apice: Colchicum,
Bafi: Plerique.
Latere: Canna.
Nedkario: Costus.
Situs in Filamentis apice: Plerique.
latere: Paris, Asarum·
Pistilloz Aristolochia.
Receptaculoz Arum.
PQLLEN figura : globus echinatus: Helianthus.
perforatus: Geranium.
didymus: Symplzytum.
rotatus dentatus ε Malva.
angulfitus: V iola.
reniformiS: Narczffus.
Philyra convoluta : Borrago.

τοι. PI- η,

